alcove	alcove
attic	attic
basement	garage
bathroom	bathroom
bedchamber	bedroom
bedroom	bedroom
bow_window/indoor	alcove
childs_room	bedroom
closet	closet
dining_room	living_room
dorm_room	bedroom
garage/indoor	garage
home_office	office
home_theater	living_room
hotel_room	bedroom
kitchen	kitchen
laundromat	laundry
living_room	living_room
nursery	nursery
nursing_home	nursing
pantry	pantry
playroom	bedroom
recreation_room	bedroom
restaurant_kitchen	kitchen
shower	bathroom
staircase	staircase
television_room	living_room
utility_room	utility
wet_bar	kitchen
youth_hostel	bedroom
